11111111111111111111111
1E000C0000C0000001C0001
1000011100100C001111001
1101P001001001001000N01
1C000000000001000000C11
1C00000100N0010N0000C11
1C0000C100000C000000C11
11111111111111111111111
