11111111111111111111111111111111111111
100000000000000000000000000000N0000001
10E0000C000001111111011111111111111101
100000000011111111C0011110001111111101
1000C0001111111PC00001010C001111111101
1000N11111111C000000010000001111111C01
1001111111000000N000000001111111100001
10111111C00000000000000111111100000001
101111CCCCCCC0CCCCCC011111110000N00001
10111111111111111111011111110000011101
10111111111111111111011111110C01111101
10111111111111111111011111111111111101
100C00000000011111110000000000000C0001
10000000000C011111110000000000000C0001
10000000000C000000000000000C0000000001
11111111111111111111111111111111111111
