111111111111
1000C0000E01
10P000000001
111111111111
