111111111
1PE1C0001
100110001
1C00001C1
10000C111
111111111
