1111111111111111111111111111111111
1000000000000000000000000000000001
10P00000000000000000000001C0000001
1000000000000000000000000100000001
10000C0000000000000000000100000001
1000000000000000000000000111100001
1111110000000000000000000000000001
1000000000000000000000000000000001
100000000C000000000000000000000001
1000000000000000000000000000000001
1000000000001100000000000000000001
1000000000000000000000000000000001
1000000000000000000C10000000000001
1000000000000000010000000000000001
1000000000000000000000000000000001
10000000000000000000000001111C0001
10000000000000000000000001C0000001
1000000C00000000000000000000000E11
1000000000000000000000000000001111
1111111111111111111111111111111111
