1111111111111111111111
1E000C0000000000C00001
101001010010C0C0101001
1010010010101010001001
1P0000000C00C000CC0001
1111111111111111111111
