1111111111111111111111111111111111
1000000000000000000000000000000001
10P00000000000000000000001C0000001
11110000000000010C0100000100000001
1C000C00000000011111000001C0000001
1111110000000000000000000111100001
1C000000000C0C00000000000000000001
1000000011111110000000000000000001
10000000000000000000C0000000000001
100CC00000000000C000100001111C0001
10011000000011111000100001C0010001
1000000C1000000C100010000000000E11
1000000010000000100010000000001111
1111111111111111111111111111111111
